########
##   ###
##.#x ##
# x    #
#. .#x #
### @ ##
### # ##
###   ##
########