########
###   ##
# x # ##
# #  . #
# .  # #
##x#.x #
##@  ###
########