########
###   ##
# x # ##
# #  . #
#    # #
##x#.  #
##@  ###
########