##############
########  ####
#          ###
# @xx ##   ..#
# xx   ##  ..#
#         ####
##############