#########
##   ####
# . . .##
# # ## ##
#    xx@#
### # x #
###   ###
#########
