########
###   ##
#. x @##
### x.##
#.##x ##
# # . ##
#x Xxx.#
#   .  #
########