########
#@.....#
# xxxxx#
# .....#
# xxxxx#
#      #
########